WWWWWWWWWWWWWWWWWWWWWWWWW
WPGGGGWGGGGGGGGGGGGGGGGGW
WWWWWGWGGGGGGGGGGGGGGGGGW
WGGGWGWGGGGGGGGGGGGGGGGGW
WGGGGGGGGGGGGGGGGGGGGGGGW
WWWWWWWWGGGGGGGGGGGGGGGGW
WGGGGGGWGGGGGGGGGGGGGGGGW
WGGGGGGWGGGGGGGGGGGGGGGGW
WGGGGGGWGGGGGGGGGGGGGGGGW
WGGGGGGWGGGGGGGGGGGGGGGGW
WGGGGGGGGGGGGGGGGGGGGGGGW
WGGGGGGGGGGGGGGGGGGGGGGGW
WGGGGGGGGGGGGGGGGGGGGGGGW
WGGGGGGGGGGGGGGGGGGGGGGGW
WGGGGGGGGGGGGGGGGGGGGGGGW
WGGGGGGGGGGGGGGGGGGGGGGGW
WGGGGGGGGGGGGGGGGGGGGGGGW
WGGGGGGGGGGGGGGGGGGGGGGGW
WWWWWWWWWWWWWWWWWWWWWWWWW
