WWWWWWWWWWWWWWWWWWWWWWWWW
WCSSSSCSSSSCWCSSSSCSSSSCW
WBWWWWSWWWWSWSWWWWSWWWWBW
WSWWWWSWWWWSWSWWWWSWWWWSW
WCSSSSCSCSSCSCSSCSCSSSSCW
WSWWWWSWSWWWWWWWSWSWWWWSW
WCSSSSCWCSSCWCSSCWCSSSSCW
WWWWWWSWWWWGWGWWWWSWWWWWW
WWWWWWSWRGGGGGGGRWSWWWWWW
WWWWWWSWGWWWWWWWGWSWWWWWW
pGGGGGCGRWWWWWWWRGCGGGGGt
WWWWWWSWGWWWWWWWGWSWWWWWW
WWWWWWSWRGGGGGGGRWSWWWWWW
WWWWWWSWGWWWWWWWGWSWWWWWW
WCSSSSCSCSSCWCSSCSCSSSSCW
WSWWWWSWWWWSWSWWWWSWWWWSW
WTSSCWCSCGGGPGGGCSCWCSSTW
WWWWSWSWSWWWWWWWSWSWSWWWW
WCSSCSCWCSSCWCSSCWCSCSSCW
WSWWWWWWWWWSWSWWWWWWWWWSW
WCSSSSSSSSSCSCSSSSSSSSSCW
WWWWWWWWWWWWWWWWWWWWWWWWW