WWWWWWWWWWWWWWWWWWWWWWWWW
WPGGGGGGGGGGWGGGGGGGGGGGW
WGWWWWGWWWWGWGWWWWGWWWWGW
WGWWWWGWWWWGWGWWWWGWWWWGW
WGGGGGGGGGGGGGGGGGGGGGGGW
WGWWWWGWGWWWWWWWGWGWWWWGW
WGGGGGGWGGGGWGGGGWGGGGGGW
WWWWWWGWWWWGWGWWWWGWWWWWW
WWWWWWGWGGGGGGGGGWGWWWWWW
WWWWWWGWGWWWWWWWGWGWWWWWW
GGGGGGGGGWWWWWWWGGGGGGGGG
WWWWWWGWGWWWWWWWGWGWWWWWW
WWWWWWGWGGGGGGGGGWGWWWWWW
WWWWWWGWGWWWWWWWGWGWWWWWW
WGGGGGGGGGGGWGGGGGGGGGGGW
WGWWWWGWWWWGWGWWWWGWWWWGW
WGGGGWGGGGGGGGGGGGGWGGGGW
WWWWGWGWGWWWWWWWGWGWGGWWW
WGGGGGGWGGGGWGGGGWGGGGGGW
WGWWWWWWWWWGWGWWWWWWWWWGW
WGGGGGGGGGGGGGGGGGGGGGGGW
WWWWWWWWWWWWWWWWWWWWWWWWW