WWWWWWWWWWWWWWWWWWWWWWWWW
WSSSSSSSSSSSWSSSSSSSSSSSW
WBWWWWSWWWWSWSWWWWSWWWWBW
WSWWWWSWWWWSWSWWWWSWWWWSW
WSSSSSSSSSSSSSSSSSSSSSSSW
WSWWWWSWSWWWWWWWSWSWWWWSW
WSSSSSSWSSSSWSSSSWSSSSSSW
WWWWWWSWWWWSWSWWWWSWWWWWW
WWWWWWSWGGGGGGGGGWSWWWWWW
WWWWWWSWGWWWDWWWGWSWWWWWW
pGGGGGSGGWgggggWGGSGGGGGt
WWWWWWSWGWWWWWWWGWSWWWWWW
WWWWWWSWGGGGGGGGGWSWWWWWW
WWWWWWSWSWWWWWWWSWSWWWWWW
WSSSSSSSSSSSWSSSSSSSSSSSW
WSWWWWSWWWWSWSWWWWSWWWWSW
WSSSSWSSSSSSPSSSSSSWSSSSW
WWWWSWSWSWWWWWWWSWSWSWWWW
WSSSSSSWSSSSWSSSSWSSSSSSW
WSWWWWWWWWWSWSWWWWWWWWWSW
WSSSSSSSSSSSSSSSSSSSSSSSW
WWWWWWWWWWWWWWWWWWWWWWWWW